12 24 25 26 27 24 25 26 27 26 24 13
20 41 41 41 41 41 41 41 41 41 41 22
21 41 41 45 41 41 41 41 41 41 41 23
20 41 46 47 48 41 41 49 50 51 41 22
21 41 41 41 41 41 41 41 41 41 41 23
14 28 29 30 31 28 29 30 31 28 29 15