12 24 25 26 27 24 25 26 27 26 24 13 11 11 11 11 11 11 11
20 32 33 34 33 34 33 34 33 34 35 22 11 11 11 11 11 11 11
21 42 43 44 43 42 43 44 45 43 36 23 11 11 11 11 11 11 11
20 43 49 50 51 41 41 46 47 48 36 22 11 11 11 11 11 11 11
21 40 38 39 41 41 38 39 38 39 37 23 11 11 11 11 11 11 11
14 28 29 30 16 41 18 30 31 28 29 15 11 11 11 11 11 11 11
11 11 11 11 20 41 22 11 11 11 11 11 11 11 11 11 11 11 11
11 11 11 11 20 41 22 11 11 11 11 11 11 11 11 11 11 11 11
11 11 11 12 27 41 25 26 27 26 24 27 26 27 26 24 27 26 13
11 11 11 20 42 43 44 43 42 43 44 41 42 43 44 43 44 41 22
11 11 11 21 43 42 43 44 43 42 43 44 44 41 42 43 41 42 23
11 11 11 14 28 29 30 31 28 29 16 42 43 44 41 42 44 41 23
11 11 11 11 11 11 11 11 11 11 21 44 43 42 43 44 41 42 22
11 11 11 11 11 11 11 11 11 11 20 41 42 43 44 43 44 41 23
11 11 11 11 11 11 11 11 11 11 21 42 43 44 41 42 44 41 22
11 11 11 11 11 11 11 11 11 11 21 44 43 42 43 44 41 42 23
11 11 11 11 11 11 11 11 11 11 14 28 29 30 28 29 30 28 15