7 6 6 6 6 6 6 6 6 6 6 8
4 0 1 2 2 1 0 0 0 1 0 2
4 1 2 0 1 0 1 2 0 2 1 0
4 2 1 2 1 1 2 0 1 1 0 1
4 0 2 1 0 2 0 1 0 2 1 0
4 0 0 2 0 1 1 2 2 0 2 1
9 3 3 3 3 3 3 3 3 3 3 10